....o.......................
#######=########............
.......=-----------....o....
.......=.....##=...######=##
.......=.....##=.........=..
.....e.=.....##=......oe.=..
##=#####.....#######=#######
..=.................=.......
..=...........e.....=.......
#########=##########=.......
.........=..........=.......
.......o.=----------=...o...
....=######.........#######=
....=.........p..o.........=
############################
